111111111111111111111111111111111111
10000000000000000000000000ECCC000001
100000000000P10000000000000000000001
1C000000000000000000000000C00C000001
1C111110000C00000000000000000C000001
1C000000000C00000000000000000C000001
1C000000000000000000000000C00C000001
1C00000000C00000000000000000C0000001
111111111111111111111111111111111111
