111111111111111111111111
10000000000000C000000001
1C0000000C0000000C000P01
1E000000000000C000000C01
111111111111111111111111
