11111111111111111
10000P00E000C0001
10000000000000001
1111111111111111
